1111111111111111111111111111111
1111111111111111111111111111111
1E0000000000C00000C000000000001
10100001000E010100P000000100101
1010010101010001001000000010101
100000C00C000000000000000000001
10000000C0000000000000000000011
100000C00C000000000000000000001
1111111111111111111111111111111